WALLS   ./assets/walls/

F       ./assets/floor/0.xpm
C       ./assets/ceiling/0.xpm
DOOR    ./assets/door/

P_IN    ./assets/west.xpm
P_OUT   ./assets/west.xpm

        1111111111124343434343431
        1000000000130000000000004
        1011000001140000000000003
        1001010000000000000000004
111111111011010002140000000000003
10000000001100000213043434d434342
71110111111111011100000010001
111101111111110111010100d0001
11000000110101011100000010001
10000000000000000000000000001
10000000000000001101010010005
11000001110101011111011110N0111
11110111 1110101 101111010001
11111111 1111111 111111111111
