WALLS ./assets/walls/
F ./assets/floor/0.xpm
C ./assets/ceiling/0.xpm
P_IN ./assets/walls/1.xpm
P_OUT ./assets/walls/1.xpm

        1111111111124343434343431
        1000000000130000000000004
        1011000001140000000000003
        1001010000000000000000004
111111111011010002140000000000003
100000000011000002130434343434342
71110111111111011100000010001
11110111111111011101010010001
11000000110101011100000050001
10000000000000000000000000001
10000000000000001101010010001
11000001110101011111011110N0111
11110111 1110101 101111010001
11111111 1111111 111111111111
